1BBBBBBBBBBBBBBBBBBBBB |
 X X X X X X X X X X X |
 BBBBBBBBBBBBBBBBBBBBB |
 X X X X X X X X X X X |
 BBBBBBBBBBBBBBBBBBBBB |
 X X X X X X X X X X X |
 BBBBBBBBBBBBBBBBBBBBB2|
------------------------
