 XBXBXBXBXBXBXBXBXBXBX2|
 B B B B B B B B B B B |
 XBXBXBXBXBXBXBXBXBXBX |
 B B B B B B B B B B B |
 XBXBXBXBXBXBXBXBXBXBX |
 B B B B B B B B B B B |
1XBXBXBXBXBXBXBXBXBXBX |
------------------------
